WF = Wallis and Futuna
JT = Johnston Island
WK = Wake Island
011 = Western Africa
013 = Central America
014 = Eastern Africa
015 = Northern Africa
017 = Middle Africa
018 = Southern Africa
019 = Americas
GW = Guinea-Bissau
GU = Guam
GT = Guatemala
GS = South Georgia and the South Sandwich Islands
GR = Greece
GQ = Equatorial Guinea
GP = Guadeloupe
JP = Japan
GY = Guyana
GG = Guernsey
GF = French Guiana
GE = Georgia
GD = Grenada
GB = United Kingdom
GA = Gabon
GN = Guinea
GM = Gambia
GL = Greenland
GI = Gibraltar
GH = Ghana
JM = Jamaica
JO = Jordan
WS = Samoa
419 = Latin America and the Caribbean
039 = Southern Europe
JE = Jersey
030 = Eastern Asia
034 = Southern Asia
035 = South-Eastern Asia
PR = Puerto Rico
PS = Palestinian Territory
830 = Channel Islands
PW = Palau
PT = Portugal
PU = U.S. Miscellaneous Pacific Islands
PZ = Panama Canal Zone
PY = Paraguay
PC = Pacific Islands Trust Territory
PA = Panama
PF = French Polynesia
PG = Papua New Guinea
PE = Peru
PK = Pakistan
PH = Philippines
PN = Pitcairn
PL = Poland
PM = Saint Pierre and Miquelon
ZM = Zambia
ZA = South Africa
ZZ = Unknown or Invalid Region
ZW = Zimbabwe
ME = Montenegro
MD = Moldova
MG = Madagascar
MF = Saint Martin
MA = Morocco
MC = Monaco
MM = Myanmar
ML = Mali
MO = Macau SAR China
MN = Mongolia
MI = Midway Islands
MH = Marshall Islands
MK = Macedonia
MU = Mauritius
MT = Malta
MW = Malawi
MV = Maldives
MQ = Martinique
MP = Northern Mariana Islands
MS = Montserrat
MR = Mauritania
MY = Malaysia
MX = Mexico
MZ = Mozambique
FQ = French Southern and Antarctic Territories
FR = France
150 = Europe
FX = Metropolitan France
054 = Melanesia
FI = Finland
FJ = Fiji
FK = Falkland Islands
FM = Micronesia
FO = Faroe Islands
CK = Cook Islands
CI = Ivory Coast
CH = Switzerland
CO = Colombia
CN = China
CM = Cameroon
CL = Chile
CC = Cocos Islands
CA = Canada
CG = Congo - Brazzaville
CF = Central African Republic
CD = Congo - Kinshasa
CZ = Czech Republic
CY = Cyprus
CX = Christmas Island
CS = Serbia and Montenegro
CR = Costa Rica
CV = Cape Verde
CU = Cuba
CT = Canton and Enderbury Islands
SZ = Swaziland
SY = Syria
SR = Suriname
SV = El Salvador
SU = Union of Soviet Socialist Republics
ST = Sao Tome and Principe
SK = Slovakia
SJ = Svalbard and Jan Mayen
SI = Slovenia
SH = Saint Helena
SO = Somalia
SN = Senegal
SM = San Marino
SL = Sierra Leone
SC = Seychelles
SB = Solomon Islands
SA = Saudi Arabia
SG = Singapore
SE = Sweden
SD = Sudan
YE = Yemen
YD = People's Democratic Republic of Yemen
YT = Mayotte
LB = Lebanon
LC = Saint Lucia
LA = Laos
LK = Sri Lanka
LI = Liechtenstein
LV = Latvia
LT = Lithuania
LU = Luxembourg
LR = Liberia
LS = Lesotho
LY = Libya
VA = Vatican
VC = Saint Vincent and the Grenadines
142 = Asia
VE = Venezuela
VG = British Virgin Islands
IQ = Iraq
VI = U.S. Virgin Islands
IS = Iceland
IR = Iran
IT = Italy
VN = Vietnam
003 = North America
002 = Africa
001 = World
IM = Isle of Man
IL = Israel
005 = South America
IN = India
009 = Oceania
IE = Ireland
ID = Indonesia
BD = Bangladesh
BE = Belgium
BF = Burkina Faso
BG = Bulgaria
BA = Bosnia and Herzegovina
BB = Barbados
BL = Saint Barth√©lemy
BM = Bermuda
BN = Brunei
BO = Bolivia
BH = Bahrain
BI = Burundi
BJ = Benin
BT = Bhutan
BV = Bouvet Island
BW = Botswana
BQ = British Antarctic Territory
BR = Brazil
BS = Bahamas
BY = Belarus
BZ = Belize
RU = Russia
RW = Rwanda
RS = Serbia
RE = Reunion
RO = Romania
021 = Northern America
029 = Caribbean
OM = Oman
HR = Croatia
HT = Haiti
HU = Hungary
HK = Hong Kong SAR China
145 = Western Asia
HN = Honduras
HM = Heard Island and McDonald Islands
VD = North Vietnam
143 = Central Asia
057 = Micronesian Region
053 = Australia and New Zealand
EH = Western Sahara
EE = Estonia
EG = Egypt
EC = Ecuador
ET = Ethiopia
ES = Spain
ER = Eritrea
UY = Uruguay
UZ = Uzbekistan
US = United States
UM = United States Minor Outlying Islands
UG = Uganda
UA = Ukraine
VU = Vanuatu
IO = British Indian Ocean Territory
172 = Commonwealth of Independent States
NI = Nicaragua
NL = Netherlands
NO = Norway
NA = Namibia
NC = New Caledonia
NE = Niger
NF = Norfolk Island
NG = Nigeria
NZ = New Zealand
NP = Nepal
NQ = Dronning Maud Land
NR = Nauru
NT = Neutral Zone
NU = Niue
061 = Polynesia
062 = South-Central Asia
KG = Kyrgyzstan
KE = Kenya
KI = Kiribati
KH = Cambodia
KN = Saint Kitts and Nevis
KM = Comoros
KR = South Korea
KP = North Korea
KW = Kuwait
KZ = Kazakhstan
KY = Cayman Islands
151 = Eastern Europe
DO = Dominican Republic
DM = Dominica
155 = Western Europe
154 = Northern Europe
DD = East Germany
DE = Germany
DZ = Algeria
TZ = Tanzania
TV = Tuvalu
TW = Taiwan
TT = Trinidad and Tobago
TR = Turkey
TN = Tunisia
TO = Tonga
TL = East Timor
TM = Turkmenistan
TJ = Tajikistan
TK = Tokelau
TH = Thailand
TF = French Southern Territories
TG = Togo
TD = Chad
TC = Turks and Caicos Islands
200 = Czechoslovakia
AE = United Arab Emirates
AD = Andorra
AG = Antigua and Barbuda
AF = Afghanistan
AI = Anguilla
AM = Armenia
AL = Albania
AO = Angola
AN = Netherlands Antilles
AQ = Antarctica
AS = American Samoa
AR = Argentina
AU = Australia
AT = Austria
AW = Aruba
AX = Aland Islands
DJ = Djibouti
AZ = Azerbaijan
QU = European Union
QA = Qatar
DK = Denmark
QO = Outlying Oceania

