<html>
<head>
<meta http-equiv="Content-Type" content="text/html; charset=utf-8" />
</head>
</body>
<pre>
WF = Wallis y Futuna
WF = Wallis y Futuna
JP = Japón
011 = África occidental
013 = Centroamérica
014 = África oriental
015 = África septentrional
017 = África central
018 = África meridional
019 = Américas
GW = Guinea-Bissau
GU = Guam
GT = Guatemala
GS = Islas Georgia del Sur y Sandwich del Sur
GR = Grecia
GQ = Guinea Ecuatorial
GP = Guadalupe
GY = Guyana
GG = Guernsey
GF = Guayana Francesa
GE = Georgia
GD = Granada
GB = Reino Unido
GA = Gabón
GN = Guinea
GM = Gambia
GL = Groenlandia
GI = Gibraltar
GH = Ghana
JM = Jamaica
JO = Jordania
WS = Samoa
419 = Latinoamérica y el Caribe
039 = Europa meridional
JE = Jersey
030 = Asia oriental
034 = Asia meridional
035 = Sudeste asiático
PR = Puerto Rico
PS = Palestina
PW = Palau
PT = Portugal
PY = Paraguay
PA = Panamá
PF = Polinesia Francesa
PG = Papúa Nueva Guinea
PE = Perú
PK = Pakistán
PH = Filipinas
PN = Pitcairn
PL = Polonia
PM = San Pedro y Miquelón
ZM = Zambia
ZA = Sudáfrica
ZZ = Región desconocida o no válida
ZW = Zimbabue
ME = Montenegro
MD = Moldavia
MG = Madagascar
MF = San Martín
MA = Marruecos
MC = Mónaco
MM = Myanmar
ML = Mali
MO = Región Administrativa Especial de Macao de la República Popular China
MN = Mongolia
MH = Islas Marshall
MK = Macedonia
MU = Mauricio
MT = Malta
MW = Malaui
MV = Maldivas
MQ = Martinica
MP = Islas Marianas del Norte
MS = Montserrat
MR = Mauritania
MY = Malasia
MX = México
MZ = Mozambique
FR = Francia
150 = Europa
054 = Melanesia
FI = Finlandia
FJ = Fiyi
FK = Islas Malvinas
FM = Micronesia
FO = Islas Feroe
CK = Islas Cook
CI = Costa de Marfil
CH = Suiza
CO = Colombia
CN = China
CM = Camerún
CL = Chile
CC = Islas Cocos
CA = Canadá
CG = Congo
CF = República Centroafricana
CD = República Democrática del Congo
CZ = República Checa
CY = Chipre
CX = Isla Christmas
CS = Serbia y Montenegro
CR = Costa Rica
CV = Cabo Verde
CU = Cuba
SZ = Suazilandia
SY = Siria
SR = Surinam
SV = El Salvador
ST = Santo Tomé y Príncipe
SK = Eslovaquia
SJ = Svalbard y Jan Mayen
SI = Eslovenia
SH = Santa Elena
SO = Somalia
SN = Senegal
SM = San Marino
SL = Sierra Leona
SC = Seychelles
SB = Islas Salomón
SA = Arabia Saudí
SG = Singapur
SE = Suecia
SD = Sudán
YE = Yemen
YT = Mayotte
LB = Líbano
LC = Santa Lucía
LA = Laos
LK = Sri Lanka
LI = Liechtenstein
LV = Letonia
LT = Lituania
LU = Luxemburgo
LR = Liberia
LS = Lesoto
LY = Libia
VA = Ciudad del Vaticano
VC = San Vicente y las Granadinas
142 = Asia
VE = Venezuela
VG = Islas Vírgenes Británicas
IQ = Iraq
VI = Islas Vírgenes de los Estados Unidos
IS = Islandia
IR = Irán
IT = Italia
VN = Vietnam
003 = América del Norte
002 = África
001 = Mundo
IM = Isla de Man
IL = Israel
005 = Suramérica
IN = India
009 = Oceanía
IE = Irlanda
ID = Indonesia
BD = Bangladesh
BE = Bélgica
BF = Burkina Faso
BG = Bulgaria
BA = Bosnia-Herzegovina
BB = Barbados
BL = San Bartolomé
BM = Bermudas
BN = Brunéi
BO = Bolivia
BH = Bahréin
BI = Burundi
BJ = Benín
BT = Bután
BV = Isla Bouvet
BW = Botsuana
BR = Brasil
BS = Bahamas
BY = Bielorrusia
BZ = Belice
RU = Rusia
RW = Ruanda
RS = Serbia
RE = Reunión
RO = Rumanía
021 = Norteamérica
029 = Caribe
OM = Omán
HR = Croacia
HT = Haití
HU = Hungría
HK = Hong-Kong, Región administrativa especial de China
145 = Asia occidental
HN = Honduras
HM = Islas Heard y McDonald
143 = Asia central
057 = Micronesia [057]
053 = Australia y Nueva Zelanda
EH = Sáhara Occidental
EE = Estonia
EG = Egipto
EC = Ecuador
ET = Etiopía
ES = España
ER = Eritrea
UY = Uruguay
UZ = Uzbekistán
US = Estados Unidos
UM = Islas menores alejadas de los Estados Unidos
UG = Uganda
UA = Ucrania
VU = Vanuatu
IO = Territorio Británico del Océano Índico
172 = Comunidad de Estados Independientes
NI = Nicaragua
NL = Países Bajos
NO = Noruega
NA = Namibia
NC = Nueva Caledonia
NE = Níger
NF = Isla Norfolk
NG = Nigeria
NZ = Nueva Zelanda
NP = Nepal
NR = Nauru
NU = Isla Niue
061 = Polinesia
062 = Asia centromeridional
KG = Kirguistán
KE = Kenia
KI = Kiribati
KH = Camboya
KN = San Cristóbal y Nieves
KM = Comoras
KR = Corea del Sur
KP = Corea del Norte
KW = Kuwait
KZ = Kazajistán
KY = Islas Caimán
151 = Europa oriental
DO = República Dominicana
DM = Dominica
155 = Europa occidental
154 = Europa septentrional
DE = Alemania
DZ = Argelia
TZ = Tanzania
TV = Tuvalu
TW = Taiwán
TT = Trinidad y Tobago
TR = Turquía
TN = Túnez
TO = Tonga
TL = Timor Oriental
TM = Turkmenistán
TJ = Tayikistán
TK = Tokelau
TH = Tailandia
TF = Territorios Australes Franceses
TG = Togo
TD = Chad
TC = Islas Turcas y Caicos
AE = Emiratos Árabes Unidos
AD = Andorra
AG = Antigua y Barbuda
AF = Afganistán
AI = Anguila
AM = Armenia
AL = Albania
AO = Angola
AN = Antillas Neerlandesas
AQ = Antártida
AS = Samoa Americana
AR = Argentina
AU = Australia
AT = Austria
AW = Aruba
AX = Islas Åland
DJ = Yibuti
AZ = Azerbaiyán
QU = Unión Europea
QA = Qatar
DK = Dinamarca
QO = Territorios alejados de Oceanía
</pre>
</body>
</html>
